10 10 10 10 10 10 10 10 10 10 10 10 10 10 10 10 10 10
10 10 10 10 10 10 10 10 10 10 10 10 10 10 10 10 10 10
10 10 10 10 10 10 10 10 10 10 10 10 10 10 10 10 10 10
10 10 10 10 10 10 10 10 10 10 10 10 10 10 10 10 10 10
10 10 10 10 10 10 10 10 10 10 10 10 10 10 10 10 10 10
14 14 14 14 14 14 14 14 14 14 14 14 14 14 14 14 14 14
14 14 14 14 14 14 14 14 14 14 14 14 14 14 14 14 14 14
04 04 04 04 04 04 04 04 04 04 04 04 04 04 04 04 04 04
14 14 14 14 14 14 08 14 14 14 14 14 08 14 14 14 14 14
14 14 14 14 14 14 08 14 14 14 14 14 08 14 14 14 14 14
06 06 14 06 06 14 08 14 14 14 14 14 08 14 06 06 14 06
14 14 14 14 14 14 08 14 14 14 14 14 08 14 14 14 14 14
14 14 14 14 14 14 08 14 14 14 14 14 08 14 14 14 14 14
03 03 03 03 03 03 14 07 07 07 07 07 14 03 03 03 03 03
14 14 14 14 14 14 02 14 14 14 14 14 01 14 14 14 14 14
14 14 14 14 14 14 02 14 14 05 14 14 01 14 14 14 14 14
12 12 12 12 14 14 02 14 14 05 14 14 01 14 14 11 11 11
12 12 12 12 14 14 02 14 14 14 14 14 01 14 14 11 11 11
12 12 12 12 14 14 02 14 14 05 14 14 01 14 14 11 11 11
12 12 12 12 14 14 02 14 14 05 14 14 01 14 14 11 11 11
12 12 12 12 14 14 02 14 14 14 14 14 01 14 14 11 11 11