14 14 14 14  2 14 14  5 14 14  1 14 14 14 14
14 14 14 14  2 14 14 14 14 14  1 14 14 14 14
 4  4  4  4 14  7  7  7  7  7 14  4  4  4  4
14 14 14 14  8 14 14 14 14 14  8 14 14 14 14
14 14 14 14  8 14 14 14 14 14  8 14 14 14 14
14  6  6 14  8 14 14 14 14 14  8 14  6  6 14
14 14 14 14  8 14 14 14 14 14  8 14 14 14 14
14 14 14 14  8 14 14 14 14 14  8 14 14 14 14
 3  3  3  3 14  7  7  7  7  7 14  3  3  3  3
14 14 14 14  2 14 14 14 14 14  1 14 14 14 14
14 14 14 14  2 14 14  5 14 14  1 14 14 14 14
12 12 14 14  2 14 14  5 14 14  1 14 14 11 11
12 12 14 14  2 14 14 14 14 14  1 14 14 11 11